GEN : Ծննդոց
EXO : Ելք
LEV : Ղեւտական
NUM : Թուեր
DEU : Երկրորդ Օրէնք
JOS : Յեսու
JDG : Դատաւորներ
RUT : Հռութ
1SA : Թագաւորութիւններ Ա
2SA : Թագաւորութիւններ Բ
1KI : Թագաւորութիւններ Գ
2KI : Թագաւորութիւններ Դ
1CH : Ա Մնացորդաց
2CH : Բ Մնացորդաց
EZR : Ա Եզրաս
1ES : Բ Եզրաս
NEH : Նէեմի
EST : Եսթեր
JDT : Յուդիթ
TOB : Տոբիթ
1MA : Ա Մակաբայեցիներ
2MA : Բ Մակաբայեցիներ
3MA : Գ Մակաբայեցիներ
PSA : Սաղմոս
PRO : Առակներ
ECC : Ժողովող
SNG : Երգ Երգոց
WIS : Իմաստութիւն Սողոմոնի
SIR : Սիրաք
JOB : Յոբ
ISA : Եսայի
HOS : Օսէէ
AMO : Ամոս
MIC : Միքիա
JOL : Յովէլ
OBA : Աբդիու
JON : Յովնան
NAM : Նաւում
HAB : Ամբակում
ZEP : Սոփոնիա
HAG : Անգէ
ZEC : Զաքարիա
MAL : Մաղաքիա
JER : Երեմիա
BAR : Բարուք
LAM : Ողբ
DAN : Դանիէլ
EZK : Եզեկիէլ
MAT : Մատթէոս
MRK : Մարկոս
LUK : Ղուկաս
JHN : Յովհաննէս
ACT : Գործք
ROM : Հռոմէացիներին
1CO : Կորնթացիներին Ա
2CO : Կորնթացիներին Բ
GAL : Գաղատացիներին
EPH : Եփեսացիներին
PHP : Փիլիպեցիներին
COL : Կողոսացիներին
1TH : Թեսաղոնիկեցիներին Ա
2TH : Թեսաղոնիկեցիներին Բ
1TI : Տիմոթէոսին Ա
2TI : Տիմոթէոսին Բ
TIT : Տիտոսին
PHM : Փիլիմոնին
HEB : Եբրայեցիներին
JAS : Յակոբոս
1PE : Պետրոս Ա
2PE : Պետրոս Բ
1JN : Յովհաննէս Ա
2JN : Յովհաննէս Բ
3JN : Յովհաննէս Գ
JUD : Յուդա
REV : Յայտնութիւն
