GEN : Ծնունդք
EXO : Ելք
LEV : Ղեւտական
NUM : Թիւք
DEU : Երկրորդումն օրինաց
JOS : Յեսու Նաւեայ
JDG : Դատաւորք
RUT : Հռութ
1SA : Թագաւորութեանց Ա
2SA : Թագաւորութեանց Բ
1KI : Թագաւորութեանց Գ
2KI : Թագաւորութեանց Դ
1CH : Մնացորդաց Ա
2CH : Մնացորդաց Բ
EZR : Եզրի Ա
1ES : Եզրայ Բ
NEH : Նեեմի
EST : Եսթեր
JDT : Յուդիթ
TOB : Տովբիթ
1MA : Մակաբայեցւոց Ա
2MA : Մակաբայեցւոց Բ
3MA : Մակաբայեցւոց Գ
PSA : Սաղմոս Դաւթի
PRO : Առակք Սողոմոնի
ECC : Ժողովօղ
SNG : Երգ Երգոց
WIS : Իմաստութիւն Սողոմոնի
JOB : Գիրք Յոբայ
ISA : Մարգարէութիւն Եսայայ
HOS : Մարգարէութիւն Ովսեայ
AMO : Մարգարէութիւն Ամովսայ
MIC : Մարգարէութիւն Միքիայ
JOL : Մարգարէութիւն Յովելեայ
OBA : Մարգարէութիւն Աբդիու
JON : Մարգարէութիւն Յովնանու
NAM : Մարգարէութիւն Նաւումայ
HAB : Մարգարէութիւն Ամբակումայ
ZEP : Մարգարէութիւն Սոփոնիայ
HAG : Մարգարէութիւն Անգեայ
ZEC : Մարգարէութիւն Զաքարիայ
MAL : Մարգարէութիւն Մաղաքիայ
JER : Մարգարէութիւն Երեմիայ
BAR : Թուղթ Բարուքայ
LAM : Ողբ Երեմիայ
DAN : Մարգարէութիւն Դանիելի
EZK : Մարգարէութիւն Եզեկիելի
MAT : Աւետարան ըստ Մատթէոսի
MRK : Աւետարան ըստ Մարկոսի
LUK : Աւետարան ըստ Ղուկասու
JHN : Աւետարան ըստ Յովհաննու
ACT : Գործք Առաքելոց
JAS : Յակովբոս
1PE : Պետրոսի Ա
2PE : Պետրոսի Բ
1JN : Յովհաննու Ա
2JN : Յովհաննու Բ
3JN : Յովհաննու Գ
JUD : Յուդայի
ROM : Առ Հռովմայեցիս
1CO : Առ Կորնթացիս Ա
2CO : Առ Կորնթացիս Բ
GAL : Առ Գաղատացիս
EPH : Առ Եփեսացիս
PHP : Առ Փիլիպեցիս
COL : Առ Կողոսացիս
1TH : Առ Թեսաղոնիկեցիս Ա
2TH : Առ Թեսաղոնիկեցիս Բ
HEB : Առ Եբրայեցիս
1TI : Առ Տիմոթէոս Ա
2TI : Առ Տիմոթէոս Բ
TIT : Առ Տիտոս
PHM : Առ Փիլիմոն
REV : Յայտնութիւն
